1111111111111111111111111111111111
100000000000000C000000000000000001
1010000100100000101001000000010101
1010101111111111111001110011010101
10001000001100C0001000010010100001
10000111C000000C01000C010000100001
1010111111000111110010110011101011
1010010010100010001001000000010111
1010010100100000100011100000010101
1101110010101010001000100000010101
110P00000C00C000001EC0100000000001
1111111111111111111111111111111111