1111111111111111111111111111111111
100000000000000C00000000Z000000001
10100Z00000Z000000000Z000000000101
1010100000000000000000Z0Z000000101
10001000001100C0001000010010100001
10000111C000000C01000C010000100001
1010000000000111110010110011101011
10100100101000100Z10010Z0000010111
1010010100100000100000000000010101
110111001010101000100000Z0Z0000001
110C00000C00C0000000C000Z0E00000P1
1111111111111111111111111111111111