1111111111
1CCCPC1E11
1111111111